64
20
44 44 44 44 44 44 44 44 44 44 44 44 44 44 44 44 44 44 44 44 44 44 44 44 44 44 44 44 44 44 44 44 44 44 44 44 44 44 44 44 44 44 44 44 44 44 44 44 44 44 44 44 44 44 44 44 44 44 44 44 44 44 44 44
25 42 42 42 42 42 42 42 42 42 42 42 42 42 42 42 42 42 42 42 42 42 42 42 42 42 42 42 42 42 42 42 42 42 42 42 42 42 42 42 42 42 42 42 42 42 42 42 42 42 42 42 42 42 42 42 42 42 42 42 42 26 44 44
41 0  0  0  0  0  0  0  0  0  0  0  0  0  0  0  0  0  0  0  0  0  0  0  0  0  0  0  0  0  0  0  0  0  0  0  0  0  0  0  0  0  0  0  0  0  0  0  0  0  0  0  0  0  0  0  0  0  0  0  0  43 44 44
41 0  0  0  0  0  0  0  0  0  0  0  0  0  0  0  0  0  0  0  0  0  0  0  0  0  0  0  0  0  0  0  0  0  0  0  0  0  0  0  0  0  0  0  0  0  0  0  0  0  0  0  0  0  0  0  0  0  0  0  0  43 44 44
41 0  0  0  0  0  0  0  0  0  0  0  0  0  0  0  0  0  0  0  0  0  0  0  0  0  0  0  0  0  0  0  0  0  0  0  0  0  0  0  39 40 40 40 40 36 0  0  0  0  0  0  0  0  0  0  0  0  0  0  0  43 44 44
41 0  0  0  0  0  45 46 39 40 40 40 36 0  0  0  0  0  0  0  0  0  0  0  0  0  0  0  0  0  0  0  0  0  0  0  0  0  0  0  43 44 25 42 42 37 0  0  0  0  0  0  0  0  0  0  0  0  0  0  0  43 44 44
41 0  0  0  0  0  0  0  43 44 44 44 41 0  0  0  0  0  0  0  0  29 30 31 32 0  0  0  0  0  0  0  0  0  0  0  0  0  39 40 27 44 41 0  0  0  0  0  0  0  0  0  0  0  0  0  0  0  0  0  0  43 44 44
41 0  0  0  0  0  0  0  43 44 44 25 37 0  0  0  0  0  0  0  0  13 0  0  13 0  0  0  0  0  0  0  0  0  0  0  0  0  43 44 44 44 41 0  0  0  0  0  0  0  0  0  0  0  0  0  0  0  0  0  0  43 44 44
41 0  0  0  0  0  0  0  43 44 44 41 0  0  0  0  0  0  0  0  0  13 0  0  13 0  0  0  0  0  29 30 31 32 0  0  0  0  43 44 44 44 28 40 40 36 47 48 0  0  0  0  0  0  29 30 31 32 0  0  0  43 44 44
41 0  0  0  0  0  0  0  43 44 44 41 0  0  0  0  0  0  0  0  0  13 0  0  13 0  0  0  0  0  13 0  0  13 0  0  0  0  43 44 44 44 44 44 44 41 0  0  0  0  0  0  0  0  13 0  0  13 0  0  0  43 44 44
41 47 48 0  0  0  0  0  43 44 44 41 0  0  0  0  0  0  0  0  0  13 0  0  13 0  0  0  0  0  13 0  0  13 0  0  0  0  43 44 44 44 44 44 44 41 0  0  0  0  0  0  0  0  13 0  0  13 0  0  0  43 44 44
41 0  0  0  0  0  0  0  43 44 44 41 0  0  0  0  0  0  0  0  0  13 0  0  13 0  0  0  0  0  13 0  0  13 0  0  0  0  43 44 44 44 44 44 44 41 0  0  0  0  0  0  0  0  13 0  0  13 0  0  0  43 44 44
37 0  0  0  0  0  0  0  43 44 44 41 0  0  0  0  0  0  0  0  0  13 0  0  13 0  0  0  0  0  13 0  0  13 29 30 31 32 43 44 44 44 44 44 44 41 0  0  0  0  0  0  0  0  13 0  0  13 0  0  0  38 42 42
18 0  0  0  0  0  0  0  43 44 44 41 0  0  0  0  0  0  0  0  0  13 0  0  13 0  0  0  0  0  13 0  0  13 13 0  0  13 43 44 44 44 44 44 44 41 0  0  0  0  0  0  0  0  13 0  0  13 0  0  0  0  0  0
18 0  0  0  0  0  45 46 43 44 44 41 0  0  0  0  0  0  0  0  0  13 0  0  13 0  0  0  0  0  13 0  0  13 13 0  0  13 43 44 44 44 44 44 44 41 0  0  0  0  0  0  0  0  13 0  0  13 0  0  0  0  0  0
18 0  0  0  0  0  0  0  43 44 44 41 0  0  0  0  0  0  0  0  0  13 0  0  13 0  29 30 31 32 13 0  0  13 13 0  0  13 43 44 44 44 44 44 44 41 0  0  0  0  0  0  0  0  13 0  0  13 0  0  0  0  0  0
18 0  0  0  0  0  0  0  43 44 44 41 0  0  0  0  29 30 31 32 0  13 0  0  13 0  13 0  0  13 13 0  0  13 13 0  0  13 43 44 44 44 44 44 44 41 0  0  0  0  0  0  0  0  13 0  0  13 0  0  0  0  0  0
18 0  0  0  0  0  0  0  43 44 44 41 0  0  0  0  13 0  0  13 0  13 0  0  13 0  13 0  0  13 13 0  0  13 13 0  0  13 43 44 44 44 44 44 44 41 0  0  0  0  0  0  0  0  14 0  0  14 0  0  0  0  0  0
40 40 40 40 40 40 40 40 27 44 44 41 0  0  0  0  14 0  0  14 0  14 0  0  14 0  14 0  0  14 13 0  0  14 14 0  0  14 43 44 44 44 44 44 44 41 0  0  0  0  39 40 40 40 40 40 40 40 40 40 40 40 40 40
24 24 24 24 24 24 24 24 24 24 24 24 7  7  7  7  24 7  7  24 7  24 7  7  24 7  24 7  7  24 24 7  7  24 24 7  7  24 24 24 24 24 24 24 24 24 7  7  7  7  24 24 24 24 24 24 24 24 24 24 24 24 24 24