64
20
44 44 44 44 44 44 44 44 44 44 44 44 44 44 44 44 44 44 44 44 44 44 44 44 44 44 44 44 44 44 44 44 44 44 44 44 44 44 44 44 44 44 44 44 44 44 44 44 44 44 44 44 44 44 44 44 44 44 44 44 44 44 44 44
25 42 42 42 42 42 42 42 42 42 42 42 42 42 42 42 42 42 42 42 42 42 42 42 42 42 42 42 42 42 42 42 42 42 42 42 42 42 42 42 42 42 42 42 42 42 42 42 42 42 42 42 42 42 42 42 42 42 42 42 42 26 44 44
41 0  0  0  5  0  0  0  0  0  0  0  0  0  0  4  0  4  0  0  0  0  0  0  0  0  0  0  0  0  0  0  0  0  0  0  0  0  0  4  5  5  0  0  0  0  0  0  0  0  0  5  5  0  0  0  5  4  0  0  0  43 44 44
41 0  0  0  5  0  0  0  0  0  0  0  0  0  0  4  0  4  0  0  0  0  0  0  0  0  0  0  0  0  0  0  0  0  0  0  0  0  0  4  5  5  0  0  0  0  0  0  0  0  0  5  5  0  0  0  5  4  0  0  0  43 44 44
41 0  0  0  5  0  0  0  0  0  0  0  0  0  0  4  0  4  0  0  0  0  0  0  0  0  0  0  0  0  0  0  0  0  0  0  0  0  0  4  5  5  0  0  0  0  0  0  0  0  0  5  5  0  0  0  5  4  0  0  0  43 44 44
41 0  0  0  5  0  0  0  0  0  0  0  0  0  0  4  0  4  0  0  0  0  0  0  0  0  0  0  0  0  0  0  0  0  0  0  0  0  0  4  5  5  0  0  0  0  0  0  0  0  0  5  5  0  0  0  5  4  0  0  0  43 44 44
41 0  0  0  5  0  0  0  0  0  0  0  0  0  0  4  0  4  0  0  0  0  0  0  0  0  0  0  0  0  0  0  0  0  0  0  0  0  0  4  5  5  0  0  0  0  0  0  0  0  0  5  5  0  0  0  5  4  0  0  0  43 44 44
41 0  0  0  5  0  0  0  0  0  0  0  0  0  0  4  0  4  0  0  0  0  0  0  0  0  0  0  0  0  0  0  0  0  0  0  0  0  0  4  5  5  0  0  0  0  0  0  0  0  0  5  5  0  0  0  5  4  0  0  0  43 44 44
41 0  0  0  5  0  0  0  0  0  0  0  0  0  0  4  0  4  0  0  0  0  0  0  0  0  0  0  0  0  29 30 31 32 0  0  0  0  39 40 40 40 40 40 40 36 47 48 0  0  0  5  5  0  0  0  5  4  0  0  0  43 44 44
41 0  0  0  5  0  0  0  0  0  0  0  0  0  0  4  0  4  0  0  0  0  0  0  0  0  0  0  0  0  13 0  0  13 0  0  0  0  43 44 44 44 44 44 44 41 0  0  0  0  39 40 40 40 40 40 40 40 36 0  0  43 44 44
28 40 40 40 40 36 0  0  0  0  0  0  0  0  0  4  0  4  0  0  0  29 30 31 32 0  0  0  0  0  13 0  0  13 0  0  0  0  43 44 44 44 44 44 44 41 0  0  0  0  43 44 44 44 44 44 44 44 41 0  0  43 44 44
44 44 44 44 44 41 0  0  0  0  0  0  0  8  0  4  0  4  0  0  0  13 0  0  13 0  0  0  0  0  13 0  0  13 0  0  0  0  43 44 44 44 44 44 44 41 0  0  0  0  43 44 44 44 44 44 44 44 41 0  0  43 44 44
25 42 42 42 42 37 0  0  0  0  0  0  0  9  0  4  0  4  0  0  0  13 0  0  13 0  0  0  0  0  13 0  0  13 0  0  0  0  43 44 44 44 44 44 44 41 0  0  45 46 38 42 42 42 42 42 42 42 37 0  0  38 42 42
41 0  0  4  5  0  0  0  0  0  0  39 40 40 40 36 0  4  0  0  0  13 0  0  13 0  0  0  0  0  13 0  0  13 0  0  0  0  43 44 44 44 44 44 44 41 0  0  0  0  0  5  5  0  0  0  0  4  0  0  0  0  0  0
41 0  0  4  5  0  0  0  0  0  0  38 26 44 44 41 0  4  0  0  0  13 0  0  13 0  0  0  0  0  13 0  0  13 0  0  0  0  43 44 44 44 44 44 44 41 0  0  0  0  0  5  5  0  0  0  0  4  0  0  0  0  0  0
41 0  0  4  5  0  0  0  0  0  0  0  43 44 44 28 40 36 0  0  0  13 0  0  13 0  0  0  0  0  13 0  0  13 0  0  0  0  43 44 44 44 44 44 44 41 0  0  0  0  0  5  5  0  0  0  0  4  0  0  0  0  0  0
41 0  0  4  5  0  0  0  0  0  0  0  43 44 44 44 44 41 0  0  0  13 0  0  13 0  0  0  0  0  13 0  0  13 0  0  0  0  43 44 44 44 44 44 44 41 0  0  0  0  0  5  5  0  0  0  0  4  0  0  0  0  0  0
41 0  0  4  5  0  0  0  0  0  0  0  43 44 44 44 44 41 0  0  0  14 0  0  13 0  0  0  0  0  13 0  0  13 0  0  0  0  43 44 44 44 44 44 44 41 47 48 0  0  0  5  5  0  0  0  0  4  0  0  0  0  0  0
28 40 40 40 40 40 40 40 36 0  0  0  43 44 44 44 44 28 40 40 40 36 0  0  14 0  0  0  0  0  14 0  0  14 0  0  0  0  43 44 44 44 44 44 44 41 0  0  0  0  39 40 40 40 40 40 40 40 40 40 40 40 40 40
24 24 24 24 24 24 24 24 24 7  7  7  24 24 24 24 24 24 24 24 24 24 7  7  24 7  7  7  7  7  24 7  7  24 7  7  7  7  24 24 24 24 24 24 24 24 7  7  7  7  24 24 24 24 24 24 24 24 24 24 24 24 24 24