64
20
44 44 44 44 44 44 44 44 44 44 44 44 44 44 44 44 44 44 44 44 44 44 44 44 44 44 44 44 44 44 44 44 44 44 44 44 44 44 44 44 44 44 44 44 44 44 44 44 44 44 44 44 44 44 44 44 44 44 44 44 44 44 44 44
42 42 42 42 42 42 42 42 42 42 42 42 42 42 42 42 42 42 42 42 42 42 42 42 42 42 42 42 42 42 42 42 42 42 42 42 42 42 42 42 42 42 42 42 42 42 42 42 42 42 42 42 42 42 42 42 42 42 42 42 42 42 42 26
18 0  0  0  0  0  0  0  0  5  0  0  0  0  0  0  0  0  0  0  0  0  0  0  0  0  0  0  0  0  0  0  0  0  0  0  0  0  0  0  0  0  0  0  0  0  0  0  0  0  0  0  0  0  0  0  0  0  0  0  0  0  0  18
18 0  0  0  0  0  0  0  0  5  0  0  0  0  0  0  0  0  0  0  0  0  0  0  0  0  0  0  0  0  0  0  0  0  0  0  0  0  0  0  0  0  0  0  0  0  0  0  0  0  0  0  0  0  0  0  0  0  0  0  0  0  0  18
18 0  0  0  0  0  0  0  0  5  0  0  0  0  0  0  0  0  0  0  0  0  0  0  0  0  0  0  0  0  0  0  0  0  0  0  0  0  0  0  0  0  0  0  0  0  0  0  0  0  0  0  0  0  0  0  0  0  0  0  0  0  0  18
18 0  0  0  0  0  0  0  0  5  0  0  0  0  0  0  0  0  0  0  0  0  0  0  0  0  0  0  0  0  0  0  0  0  0  0  0  0  0  0  0  0  0  0  0  0  0  0  0  0  0  0  0  0  0  0  0  0  0  0  0  0  0  18
40 40 40 36 0  0  0  0  0  5  0  0  0  0  0  0  0  0  0  29 30 31 32 0  0  0  0  0  0  0  0  0  0  0  0  0  0  0  0  0  0  0  0  0  0  0  0  0  0  0  0  0  0  0  0  0  0  0  0  0  0  0  0  18
44 44 44 41 0  0  0  0  0  5  0  0  0  0  0  0  0  0  0  13 0  0  13 0  0  0  0  0  0  0  0  0  0  0  0  0  0  0  0  0  0  0  0  0  0  0  0  0  0  0  0  0  0  0  0  0  0  0  0  0  0  0  0  18
44 44 25 37 0  0  0  0  0  5  0  0  0  0  0  0  0  0  0  13 0  0  13 0  0  0  0  0  0  0  0  0  0  0  0  0  0  0  0  0  0  0  0  0  0  0  0  0  0  0  0  0  0  0  0  0  0  0  0  0  0  0  0  18
44 44 41 0  0  0  0  0  39 40 40 40 40 40 40 36 0  0  0  13 0  0  13 0  0  0  0  0  0  0  0  0  0  0  0  0  0  0  0  0  0  0  0  0  0  0  0  0  0  0  0  0  0  0  0  0  0  0  0  0  0  0  0  18
44 44 41 0  0  0  0  0  43 44 44 44 44 44 44 41 47 48 0  13 0  0  13 29 30 31 32 0  0  0  0  0  0  0  0  0  0  0  0  0  0  0  0  0  0  0  0  0  0  0  0  0  0  0  0  0  0  0  0  0  0  0  0  18
44 44 41 0  0  0  0  0  38 42 42 42 42 42 42 37 0  0  0  13 0  0  13 13 0  0  13 0  0  0  0  0  0  0  0  0  0  0  0  0  0  0  0  0  0  0  0  0  0  0  0  0  0  0  0  0  0  0  0  0  0  0  0  18
44 44 28 40 36 0  0  0  0  0  0  0  0  0  0  0  0  0  0  13 0  0  13 13 0  0  13 0  0  0  0  0  0  0  0  0  0  0  0  0  0  0  0  0  0  0  0  0  0  0  0  0  0  0  0  0  0  0  0  0  0  0  0  18
44 44 44 44 41 0  0  0  0  0  0  0  0  0  0  0  0  0  0  13 0  0  13 13 0  0  13 0  0  0  0  0  0  0  0  0  0  0  0  0  0  0  0  0  0  0  0  0  0  0  0  0  0  0  0  0  54 55 56 0  0  0  0  18
44 44 44 44 41 0  0  0  0  0  0  0  0  0  0  0  0  0  0  13 0  0  13 13 0  0  13 0  0  0  0  0  0  0  0  0  0  0  0  0  0  0  0  0  0  0  0  0  0  0  0  0  0  0  0  0  57 58 59 0  0  0  0  18
44 44 25 42 37 0  0  29 30 31 32 29 30 31 32 29 30 31 32 49 30 31 50 13 0  0  13 0  0  0  0  0  0  0  0  29 30 31 32 0  0  0  0  0  0  0  0  0  0  0  0  0  0  0  0  0  60 61 62 0  0  0  0  18
44 44 41 0  0  0  0  13 0  0  13 13 0  0  13 13 0  0  13 13 0  0  13 13 0  0  13 0  0  0  0  0  0  0  0  13 0  0  13 0  0  0  0  0  29 30 31 32 0  0  0  0  0  0  0  0  63 64 65 0  0  0  0  18
44 44 41 0  0  0  0  14 0  0  14 14 0  0  14 14 0  0  14 13 0  0  13 13 0  0  13 0  0  0  0  0  0  0  0  13 0  0  13 0  0  0  0  0  13 0  0  13 0  0  0  0  39 40 40 40 51 52 53 40 40 40 40 40
44 44 28 40 40 40 40 40 40 40 40 40 40 40 40 40 40 40 36 14 0  0  14 14 0  0  14 39 40 40 40 40 40 40 36 14 0  0  14 0  0  0  0  0  14 0  0  14 0  0  0  0  43 44 44 44 44 44 44 44 44 44 44 44
24 24 24 24 24 24 24 24 24 24 24 24 24 24 24 24 24 24 24 24 7  7  24 24 7  7  24 24 24 24 24 24 24 24 24 24 7  7  24 7  7  7  7  7  24 7  7  24 7  7  7  7  24 24 24 24 24 24 24 24 24 24 24 24